1111111111111111111111111111111111111111
1000P00C000000E0000000000000000000000001
1111111111111111111111111111111111111111
