111111111111111111
10000000E000000001
100010000000000001
101100000000000001
10000000C000000001
10C00000C000000001
10000000C000000001
100000000000000001
100000000000000001
110000P00000000001
111111111111111111
111111111111111111
111111111111111111
111111111111111111
111111111111111111
111111111111111111
111111111111111111
111111111111111111
111111111111111111
111111111111111111
111111111111111111
111111111111111111
111111111111111111
111111111111111111
111111111111111111
111111111111111111
111111111111111111
111111111111111111
111111111111111111
111111111111111111
111111111111111111
111111111111111111
111111111111111111
111111111111111111
111111111111111111
