1111111
1010000
1000C00
EEEEEEE
PPPPPPP
